###########################
################        P #
################        X #
#                   #######
#          #       ########
#################         #
#                  ########
#          ################
#          ################
#          ################
#                        O#
###########################