############
#    P     #
#          #
#          #
#    X     #
#          #
#          #
#          #
#          #
#          #
#          #
#          #
#          ################
#                        O#
###########################