############
#         O#
#       ####
#   P      #
#######    #
# O  ##    #
#    ##    #
#          #
#       XX #
#       #  #
############
