               ############
               #     P    #
               #          #
               #          #
               #     X    #
               #          #
               #          #
               #          #
               #          #
               #          #
               #          #
               #          #
################          #
#O                        #
###########################